10
9,9,9,9,9,9,9,9,9,9,
9,8,6,0,6,0,6,0,6,9,
9,0,9,9,9,0,9,0,0,9,
9,0,0,0,0,0,9,9,0,9,
9,0,7,0,5,0,0,0,0,9,
9,0,9,9,9,9,9,9,0,9,
9,0,0,0,0,0,0,0,0,9,
9,9,9,9,9,9,9,9,0,9,
9,0,6,0,6,0,6,0,6,9,
9,9,9,9,9,9,9,9,9,9,