13
9,9,9,9,9,9,9,9,9,9
9,0,0,0,5,9,6,6,6,9
9,0,9,9,9,9,9,9,9,9
9,0,0,8,0,9,5,0,7,9
9,9,9,0,9,9,9,0,9,9
9,0,0,0,0,9,2,0,0,9
9,0,0,0,0,9,0,0,0,9
9,6,9,9,9,9,9,9,0,9
9,0,0,0,0,0,2,0,0,9
9,9,9,9,9,9,9,9,9,9
