12
9,9,9,9,9,9,9,9,9,9
9,0,9,9,0,9,8,0,0,9
9,6,9,3,0,9,9,9,0,9
9,0,0,9,0,9,0,0,0,9
9,0,9,0,9,9,0,9,9,9
9,9,9,9,0,9,0,0,0,9
9,0,9,0,9,9,9,0,9,9
9,0,0,9,0,9,0,0,0,9
9,6,0,0,9,0,9,0,0,9
9,9,9,9,9,9,9,9,9,7
