1
7,9,9,9,9,9,9,9,9,9
9,0,0,0,0,0,0,0,0,9
9,9,9,9,9,9,9,0,0,9
9,9,0,0,0,0,0,9,0,9
9,9,0,9,9,0,0,9,0,9
9,0,0,9,4,9,0,9,0,9
9,9,0,9,9,9,0,9,0,9
9,0,0,0,0,0,0,9,8,9
9,1,0,9,0,9,9,9,0,9
9,9,9,9,9,9,9,9,9,9
