1
9,9,9,9,9,9,9,9,9,9
9,0,0,0,0,0,0,8,0,9
9,0,0,9,9,9,9,9,9,9
9,0,9,0,0,0,0,0,9,9
9,0,9,0,0,9,9,0,9,9
9,0,9,0,9,4,9,0,0,9
9,0,9,0,9,9,9,0,9,9
9,0,9,0,0,0,0,0,0,9
9,0,9,9,9,0,9,0,1,9
7,9,9,9,9,9,9,9,9,9
