5
9,9,9,9,9,9,9,9,9,9,
9,7,0,0,0,0,0,0,0,9,
9,0,9,9,9,9,9,0,0,9,
9,0,9,1,1,1,1,9,0,9,
9,0,9,1,9,9,1,9,0,9,
9,0,9,1,9,9,1,9,0,9,
9,0,9,1,1,1,1,9,0,9,
9,0,9,9,9,9,9,9,0,9,
9,8,0,0,0,0,0,0,0,9,
9,9,9,9,9,9,9,9,9,9,