15
9,9,9,9,9,9,9,9,9,9
9,9,0,0,0,0,0,0,6,9
9,0,9,0,0,0,0,9,0,9
9,0,0,9,0,2,9,0,0,9
9,8,0,0,9,9,0,0,0,9
9,0,0,1,9,9,4,0,0,9
9,0,0,9,0,0,9,0,0,9
9,0,9,0,0,0,0,9,0,9
9,9,3,0,0,0,0,0,9,9
9,9,9,9,7,9,9,9,9,9
