10
9,9,9,9,9,9,9,9,9,9
9,0,0,0,9,7,0,9,6,9
9,0,0,0,9,0,0,9,0,9
9,0,0,0,9,0,0,9,0,9
9,0,0,6,9,9,9,9,0,9
9,0,0,0,9,0,0,0,9,9
9,0,0,0,9,0,0,0,0,9
9,8,0,0,9,0,0,6,0,9
9,0,0,0,0,0,0,0,0,9
9,9,9,9,9,9,9,9,9,9
