12
9,9,9,9,9,9,9,9,9,9
9,7,1,9,0,5,0,0,6,9
9,0,0,9,0,0,0,0,0,9
9,0,0,9,0,9,9,9,0,9
9,0,0,9,0,9,8,9,0,9
9,0,0,9,0,9,0,9,0,9
9,0,0,9,0,0,0,9,0,9
9,0,0,9,9,9,9,9,0,9
9,0,0,0,0,0,0,0,0,9
9,9,9,9,9,9,9,9,9,9
