5
9,9,9,9,9,9,9,9,9,9
9,0,0,0,0,0,0,0,7,9
9,0,0,9,9,9,9,9,0,9
9,0,9,1,1,1,1,9,0,9
9,0,9,1,9,9,1,9,0,9
9,0,9,1,9,9,1,9,0,9
9,0,9,1,1,1,1,9,0,9
9,0,9,9,9,9,9,9,0,9
9,0,0,0,0,0,0,0,8,9
9,9,9,9,9,9,9,9,9,9
