13
9,9,9,9,9,9,9,9,9,9
9,7,0,0,0,0,0,0,0,9
9,0,0,0,0,9,9,9,0,9
9,0,9,9,9,9,0,9,0,9
9,9,0,0,0,0,2,9,0,9
9,9,0,0,6,0,3,9,0,9
9,9,9,9,9,5,4,9,0,9
9,0,0,0,0,9,9,9,0,9
9,8,0,0,0,0,0,0,0,9
9,9,9,9,9,9,9,9,9,9
