1000
9,9,9,9,9,9,9,9,9,9
9,6,6,6,6,6,6,6,6,9
9,6,9,9,9,9,9,9,6,9
9,6,9,9,9,9,9,9,6,9
9,6,9,9,9,9,9,9,6,9
9,6,7,9,9,9,9,8,6,9
9,6,9,9,9,9,9,9,6,9
9,6,9,9,9,9,9,9,6,9
9,6,6,6,6,6,6,6,6,9
9,9,9,9,9,9,9,9,9,9
