9
9,9,9,9,9,9,9,9,9,9
9,0,0,0,0,0,0,0,0,9
9,0,0,2,2,2,0,0,0,9
9,0,2,2,2,2,2,2,0,9
9,0,9,9,9,0,9,0,0,9
9,9,0,9,0,0,9,0,0,9
9,9,0,0,0,0,0,9,0,9
9,9,9,0,0,0,9,9,9,9
7,8,0,0,0,0,0,0,1,9
9,9,9,9,9,9,9,9,9,9
