13
9,9,9,9,9,9,9,9,9,9,
9,7,6,5,4,3,2,1,0,9,
9,0,9,9,9,9,9,9,0,9,
9,0,0,0,0,0,0,9,0,9,
9,0,0,0,0,0,0,9,0,9,
9,0,8,0,5,0,0,9,0,9,
9,0,0,0,0,0,0,9,0,9,
9,0,9,9,9,9,9,9,0,9,
9,0,0,0,0,0,0,0,0,9,
9,9,9,9,9,9,9,9,9,9,