5
9,9,9,9,9,9,9,9,9,9
9,0,0,0,0,9,0,0,0,9
9,0,9,9,0,9,0,9,0,9
9,9,0,9,0,9,0,9,0,9
9,0,9,9,0,9,0,9,0,9
9,9,0,9,0,9,0,9,0,9
9,0,9,9,0,9,0,9,0,9
9,9,0,9,0,9,0,9,0,9
9,4,2,9,0,0,0,9,8,9
9,9,9,9,9,9,9,9,7,9
