5
9,9,9,9,9,9,9,9,9,9
9,0,0,0,0,0,0,0,0,9
9,0,0,0,0,0,0,0,0,9
9,0,9,9,0,0,0,0,3,9
9,0,8,9,9,9,9,2,0,9
9,0,9,9,0,0,0,0,1,9
9,0,0,0,0,0,0,0,0,9
9,0,0,0,0,0,0,0,0,9
9,7,0,0,0,0,0,0,0,9
9,9,9,9,9,9,9,9,9,9
