10
9,9,9,9,9,9,9,9,9,9,
9,0,9,9,9,6,9,9,0,9,
9,0,1,0,0,0,0,9,0,9,
9,9,9,9,9,9,0,0,0,9,
9,0,0,9,8,9,0,9,0,9,
9,9,0,0,0,0,0,9,0,9,
9,0,3,9,9,9,9,9,0,9,
9,0,0,0,0,9,9,9,9,9,
9,0,9,9,0,0,0,0,1,9,
9,9,9,9,9,9,7,9,9,9