5
9,9,9,9,9,9,9,9,9,9,
9,0,0,0,0,9,0,3,0,9,
9,0,9,9,0,9,0,9,0,9,
9,0,9,9,2,9,0,9,0,9,
9,0,9,9,0,0,0,9,0,9,
9,0,9,9,0,9,9,9,0,7,
9,1,0,0,0,0,0,0,0,9,
9,9,9,9,9,9,9,9,0,9,
9,8,0,0,0,0,0,0,0,9,
9,9,9,9,9,9,9,9,9,9,