15
9,9,9,9,9,9,9,9,9,9
9,9,0,0,0,8,0,0,9,9
9,3,9,0,0,0,0,9,0,9
9,0,0,9,1,0,9,0,0,9
7,0,0,0,9,9,0,0,0,9
9,0,0,0,9,9,2,0,0,9
9,0,0,9,4,0,9,0,0,9
9,0,9,0,0,0,0,9,0,9
9,9,0,0,0,0,0,0,6,9
9,9,9,9,9,9,9,9,9,9
