12
9,9,9,9,9,9,9,9,9,9
9,0,9,9,0,0,0,0,0,9
9,0,0,0,0,9,0,9,0,9
9,9,0,0,0,0,0,8,0,9
9,0,0,0,0,0,0,9,9,9
9,9,9,9,9,9,9,9,9,9
9,6,6,6,6,6,6,6,6,9
9,6,6,6,6,6,6,6,6,9
9,6,6,7,6,6,6,6,6,9
9,9,9,9,9,9,9,9,9,9
