11
9,9,9,9,9,9,9,9,9,9
9,4,0,0,0,9,0,0,0,9
9,0,9,0,0,0,0,8,0,9
9,9,9,0,0,9,0,0,0,9
9,0,0,0,0,9,0,0,3,9
9,9,9,9,0,9,9,9,9,9
9,6,0,2,9,0,0,0,1,9
9,9,9,9,0,9,9,9,9,9
9,0,0,0,0,0,0,0,0,9
9,9,9,9,9,7,9,9,9,9
