13
9,9,9,9,9,9,9,9,9,9
9,8,0,9,9,9,0,0,7,9
9,0,0,9,0,0,9,0,0,9
9,0,0,9,0,0,9,0,0,9
9,0,0,9,6,0,9,0,0,9
9,0,9,5,0,0,9,9,0,9
9,0,9,4,3,2,0,9,0,9
9,0,9,9,9,9,9,9,0,9
9,0,0,0,0,0,0,0,0,9
9,9,9,9,9,9,9,9,9,9
