11
9,9,9,9,9,9,9,9,9,9
7,0,0,0,0,0,0,8,0,9
9,0,0,0,0,0,1,0,0,9
9,0,0,0,1,1,0,0,0,9
9,0,0,1,1,1,1,1,0,9
9,0,0,0,0,1,1,1,0,9
9,0,0,0,1,1,1,0,0,9
9,0,0,1,1,1,1,0,0,9
9,0,0,0,0,0,0,0,0,9
9,9,9,9,9,9,9,9,9,9
