12
9,9,9,9,9,9,9,9,9,9
9,0,0,0,0,0,0,0,7,9
9,0,0,0,0,0,0,0,1,9
9,0,9,9,9,9,9,9,9,9
9,0,9,0,0,0,0,0,0,9
9,0,9,0,9,9,9,0,5,9
9,0,9,0,0,8,9,0,0,9
9,0,9,9,9,9,9,0,0,9
9,0,0,0,0,0,0,0,6,9
9,9,9,9,9,9,9,9,9,9
