3
9,9,9,9,9,9,9,9,9,9
9,0,3,0,0,0,5,0,0,9
9,0,0,0,0,0,0,0,0,9
9,0,9,9,9,9,0,0,0,9
9,0,0,0,0,0,9,0,0,9
9,0,1,9,9,0,0,9,7,9
9,0,0,0,0,9,0,0,9,9
9,0,2,0,4,0,9,0,0,9
9,0,0,0,0,0,0,9,8,9
9,9,9,9,9,9,9,9,9,9
