3
9,9,9,9,9,9,9,9,9,9
9,8,9,2,9,0,0,3,0,9
9,0,9,0,0,0,0,0,0,9
9,0,9,1,0,9,9,9,9,9
9,0,9,9,0,0,0,9,7,9
9,0,9,0,0,9,0,9,0,9
9,0,9,0,9,5,0,9,0,9
9,0,9,0,9,0,0,9,0,9
9,0,0,0,9,4,0,0,0,9
9,9,9,9,9,9,9,9,9,9
