33
9,9,9,9,9,9,9,9,9,9
9,0,0,0,0,0,0,0,7,9
9,0,9,9,9,0,0,0,0,9
9,6,6,6,9,6,6,6,0,9
9,6,0,0,9,6,0,0,0,9
9,6,6,0,9,6,6,0,0,9
9,6,0,0,9,6,0,0,0,9
9,6,6,6,9,6,6,6,0,9
9,8,0,0,9,0,0,0,0,9
9,9,9,9,9,9,9,9,9,9
