5
9,9,9,9,9,9,9,9,9,9
9,0,0,0,0,0,0,0,7,9
9,0,0,0,0,0,0,0,0,9
9,0,0,0,0,0,0,0,0,9
9,1,0,0,0,0,9,9,0,9
9,0,2,9,9,9,9,8,0,9
9,3,0,0,0,0,9,9,0,9
9,0,0,0,0,0,0,0,0,9
9,0,0,0,0,0,0,0,0,9
9,9,9,9,9,9,9,9,9,9
