2
9,9,9,9,9,9,9,9,9,9
9,0,0,0,0,0,0,0,0,9
9,0,9,0,9,0,9,9,0,9
9,0,9,0,9,0,9,0,7,9
9,0,9,0,9,0,9,9,9,9
9,0,9,0,9,0,0,0,4,9
9,0,9,3,9,0,9,9,9,9
9,2,9,9,9,0,0,9,8,9
9,0,0,0,0,1,0,0,0,9
9,9,9,9,9,9,9,9,9,9
