33
9,9,9,9,9,9,9,9,9,9
9,8,6,6,6,6,6,0,0,9
9,0,6,0,6,0,6,9,0,9
9,0,6,0,0,0,6,9,0,9
9,9,9,9,9,9,9,9,0,9
9,0,6,6,6,6,6,0,0,9
9,0,6,0,6,0,6,0,0,9
9,0,6,0,0,0,6,0,0,9
9,0,0,0,0,0,0,0,7,9
9,9,9,9,9,9,9,9,9,9
