2
9,9,9,9,9,9,9,9,9,9
9,3,0,0,0,0,0,0,0,9
9,9,9,0,9,9,9,9,4,9
9,0,0,0,9,7,0,0,0,9
9,0,9,0,9,9,9,9,9,9
9,0,9,0,5,9,8,9,1,9
9,0,9,0,2,9,0,9,0,9
9,0,9,9,9,9,0,9,0,9
9,0,0,0,0,0,0,0,0,9
9,9,9,9,9,9,9,9,9,9
