5
9,9,9,9,9,9,9,9,9,9
9,7,0,0,0,0,0,0,0,9
9,0,0,0,9,8,9,0,0,9
9,0,0,0,9,9,9,0,0,9
9,0,0,0,0,9,0,0,0,9
9,0,0,0,0,9,0,0,0,9
9,0,0,0,0,9,0,0,0,9
9,0,0,0,0,2,0,0,0,9
9,0,0,0,1,0,3,0,0,9
9,9,9,9,9,9,9,9,9,9
