12
7,9,9,9,9,9,9,9,9,9
9,0,0,9,0,9,0,0,6,9
9,0,0,0,9,0,9,0,0,9
9,9,0,9,9,9,0,9,0,9
9,0,0,0,9,0,9,9,9,9
9,9,9,0,9,9,0,9,0,9
9,0,0,0,9,0,9,0,0,9
9,0,9,9,9,0,3,9,6,9
9,0,0,8,9,0,9,9,0,9
9,9,9,9,9,9,9,9,9,9
