13
9,9,9,9,9,9,9,9,9,9
9,0,0,2,0,0,0,0,0,9
9,0,9,9,9,9,9,9,6,9
9,0,0,0,9,0,0,0,0,9
9,0,0,2,9,0,0,0,0,9
9,9,0,9,9,9,0,9,9,9
9,7,0,5,9,0,8,0,0,9
9,9,9,9,9,9,9,9,0,9
9,6,6,6,9,5,0,0,0,9
9,9,9,9,9,9,9,9,9,9
