1
9,9,9,9,9,9,9,9,9,9,
9,7,0,0,0,0,0,0,0,9,
9,0,9,9,0,9,9,0,9,9,
9,0,0,0,0,0,9,0,0,9,
9,0,9,9,0,0,0,0,0,9,
9,0,0,9,1,9,9,9,0,9,
9,0,0,0,0,0,9,0,0,9,
9,0,9,9,0,9,0,9,8,9,
9,0,0,0,0,0,0,0,0,9,
9,9,9,9,9,9,9,9,9,9,