11
9,9,9,9,9,9,9,9,9,9
9,0,0,0,3,9,1,9,0,9
9,0,8,0,0,9,0,9,0,9
9,0,0,0,0,9,0,9,0,9
9,9,0,9,9,9,0,9,0,7
9,0,0,0,0,0,9,0,0,9
9,0,0,0,0,9,2,9,0,9
9,0,9,9,0,9,0,9,0,9
9,4,0,9,0,9,6,9,0,9
9,9,9,9,9,9,9,9,9,9
