13
9,9,9,9,9,9,9,9,9,9
9,0,0,0,0,0,0,0,8,9
9,0,9,9,9,0,0,0,0,9
9,0,9,4,5,9,9,9,9,9
9,0,9,3,0,6,0,0,9,9
9,0,9,2,0,0,0,0,9,9
9,0,9,0,9,9,9,9,0,9
9,0,9,9,9,0,0,0,0,9
9,0,0,0,0,0,0,0,7,9
9,9,9,9,9,9,9,9,9,9
