10
9,9,9,9,9,9,9,9,9,9
9,6,0,0,0,9,0,0,0,9
9,9,9,9,9,0,0,6,0,9
9,0,0,0,9,0,0,0,0,9
9,7,0,0,9,0,0,0,0,9
9,9,9,9,9,9,9,9,0,9
9,0,0,0,6,0,0,0,0,9
9,0,0,0,0,0,0,0,0,9
9,0,0,0,0,0,0,8,0,9
9,9,9,9,9,9,9,9,9,9
