9
9,9,9,9,9,9,9,9,9,9
9,1,0,0,0,0,0,0,8,7
9,9,9,9,0,0,0,9,9,9
9,0,9,0,0,0,0,0,9,9
9,0,0,9,0,0,9,0,9,9
9,0,0,9,0,9,9,9,0,9
9,0,2,2,2,2,2,2,0,9
9,0,0,0,2,2,2,0,0,9
9,0,0,0,0,0,0,0,0,9
9,9,9,9,9,9,9,9,9,9
