12
9,9,9,9,9,9,9,9,9,9
9,6,6,6,9,0,9,0,0,9
9,6,6,6,9,0,0,0,9,9
9,7,6,6,9,0,0,0,9,9
9,6,6,6,9,0,0,0,0,9
9,6,6,6,9,0,0,9,0,9
9,6,6,6,9,0,0,0,0,9
9,6,6,6,9,9,8,9,0,9
9,6,6,6,9,9,0,0,0,9
9,9,9,9,9,9,9,9,9,9
