8
9,9,9,9,9,9,9,9,9,9
9,0,0,0,1,0,0,0,8,9
9,0,0,0,0,0,0,0,0,9
9,0,0,9,9,0,9,0,0,9
9,0,0,9,0,0,9,0,0,9
9,0,0,9,0,0,9,0,6,9
9,0,0,9,0,0,9,9,9,9
9,0,0,9,0,0,5,0,0,9
9,9,0,9,0,0,0,0,0,9
7,9,9,9,9,9,9,9,9,9
