10
9,9,9,9,9,9,9,9,9,9
9,0,8,0,0,0,0,0,0,9
9,0,0,0,0,0,0,0,0,9
9,0,0,0,0,6,0,0,0,9
9,0,9,9,9,9,9,9,9,9
9,0,0,0,0,9,0,0,7,9
9,0,0,0,0,9,0,0,0,9
9,0,6,0,0,9,9,9,9,9
9,0,0,0,9,0,0,0,6,9
9,9,9,9,9,9,9,9,9,9
