5
9,9,9,9,9,9,9,9,9,9
9,2,0,0,0,0,9,0,7,9
9,9,0,9,0,0,9,0,0,9
9,0,0,9,0,0,9,5,0,9
9,0,0,9,0,0,9,9,0,9
9,1,0,9,0,0,9,0,0,9
9,9,0,9,0,0,0,0,0,9
9,0,0,9,0,9,9,0,0,9
9,8,9,3,0,4,9,0,0,9
9,9,9,9,9,9,9,9,9,9
