1000
9,9,9,9,9,9,9,9,9,9
9,6,6,6,6,6,6,6,6,9
9,6,9,9,9,9,9,9,6,9
9,6,9,9,9,9,9,9,6,9
9,6,8,9,9,9,9,7,6,9
9,6,9,9,9,9,9,9,6,9
9,6,9,9,9,9,9,9,6,9
9,6,9,9,9,9,9,9,6,9
9,6,6,6,6,6,6,6,6,9
9,9,9,9,9,9,9,9,9,9
