15
9,9,9,9,9,9,9,9,9,9
9,6,0,0,0,0,0,0,9,9
9,0,9,0,0,0,0,9,0,9
9,0,0,9,0,4,9,0,0,9
9,0,0,2,9,9,0,0,0,9
9,0,0,0,9,9,0,0,0,7
9,0,0,9,0,1,9,0,0,9
9,0,9,0,0,0,0,9,3,9
9,9,0,0,8,0,0,0,9,9
9,9,9,9,9,9,9,9,9,9
