12
9,9,9,9,9,9,9,9,9,9
9,6,0,0,0,0,0,0,0,9
9,0,0,9,9,9,9,9,0,9
9,0,0,9,8,0,0,9,0,9
9,5,0,9,9,9,0,9,0,9
9,0,0,0,0,0,0,9,0,9
9,9,9,9,9,9,9,9,0,9
9,1,0,0,0,0,0,0,0,9
9,7,0,0,0,0,0,0,0,9
9,9,9,9,9,9,9,9,9,9
