4
9,9,9,9,9,9,9,9,9,9
9,8,0,9,0,0,9,0,0,9
9,9,1,9,0,0,0,4,0,9
9,0,0,9,0,0,9,3,0,9
9,0,9,0,9,0,9,0,0,9
9,0,9,0,9,2,9,0,0,9
9,0,9,0,9,0,9,7,0,9
9,0,9,0,9,0,9,9,9,9
9,0,0,0,0,0,0,0,0,9
9,9,9,9,9,9,9,9,9,9
