130
9,9,9,9,9,9,9,9,9,9
9,1,9,7,0,0,0,0,0,9
9,9,9,0,0,0,9,0,0,9
9,0,0,0,0,0,9,0,8,9
9,0,0,9,9,9,0,0,0,9
9,0,0,9,6,2,9,0,0,9
9,0,0,9,3,1,9,0,0,9
9,0,0,0,9,9,9,0,0,9
9,0,0,0,0,0,0,0,0,9
9,9,9,9,9,9,9,9,9,9
