12
9,9,9,9,9,9,9,9,9,9
9,1,1,1,1,1,1,1,1,9
9,1,0,0,0,0,0,0,1,9
9,1,0,0,0,0,0,0,1,9
7,0,0,0,0,8,0,0,1,9
9,1,0,0,0,0,0,0,1,9
9,1,0,0,0,0,0,0,1,9
9,1,0,0,0,0,0,0,1,9
9,1,1,1,1,1,1,1,1,9
9,9,9,9,9,9,9,9,9,9
