1
9,9,9,9,9,9,9,9,9,7
9,1,0,9,0,9,9,9,0,9
9,0,0,0,0,0,0,9,0,9
9,9,0,9,9,9,0,9,0,9
9,0,0,9,4,9,0,9,0,9
9,9,0,9,9,0,0,9,0,9
9,9,0,0,0,0,0,9,0,9
9,9,9,9,9,9,9,0,0,9
9,0,8,0,0,0,0,0,0,9
9,9,9,9,9,9,9,9,9,9
