15
9,9,9,9,9,9,9,9,9,9,
9,8,1,0,0,0,0,0,5,9,
9,9,9,0,9,9,9,0,0,9,
9,1,0,0,0,0,9,0,9,9,
9,0,0,9,9,0,0,0,9,9,
9,0,9,9,0,9,0,0,1,9,
9,0,0,0,0,0,0,9,9,9,
9,9,9,9,0,0,9,9,9,9,
9,4,0,0,9,9,9,1,0,9,
9,7,9,9,9,9,9,9,9,9