3
9,9,9,9,9,9,9,9,9,9
9,4,9,2,0,0,0,0,0,9
9,0,9,9,9,9,9,9,0,9
9,0,0,0,0,0,0,0,0,9
9,0,9,9,9,9,0,0,0,9
9,0,9,0,0,5,9,0,1,9
9,0,0,0,9,9,0,0,0,9
9,0,9,0,0,9,0,9,9,9
9,3,9,0,8,9,0,0,7,9
9,9,9,9,9,9,9,9,9,9
