2
9,9,9,9,9,9,9,9,9,9
9,7,0,0,9,9,0,0,9,9
9,0,9,0,9,1,9,0,0,9
9,9,4,0,9,0,9,9,0,9
9,3,9,0,9,0,9,0,0,9
9,0,0,0,9,0,0,0,9,9
9,0,9,0,0,0,9,0,8,9
9,0,0,9,9,0,9,9,9,9
9,0,9,2,0,0,9,0,0,9
9,9,9,9,9,9,9,9,9,9
