5
9,9,9,9,9,9,9,9,9,9
9,0,0,0,0,0,0,0,8,7
9,0,9,9,9,9,9,9,9,9
9,0,0,0,0,0,0,0,0,9
9,9,9,9,9,9,9,9,0,9
9,0,0,0,0,0,0,0,0,9
9,0,9,9,9,9,9,9,9,9
9,0,9,0,9,0,9,0,2,9
9,0,0,9,0,9,0,9,4,9
9,9,9,9,9,9,9,9,9,9
