10
9,9,9,9,9,9,9,9,9,9
9,7,0,0,9,0,0,0,8,9
9,0,0,9,9,0,0,0,0,9
9,9,9,9,0,9,9,9,9,9
9,0,0,0,9,0,0,0,0,9
9,0,0,0,9,0,0,0,0,9
9,0,6,6,9,6,6,0,0,9
9,0,0,0,9,0,0,0,0,9
9,0,0,0,9,0,0,0,0,9
9,9,9,9,9,9,9,9,9,9
