15
9,9,9,9,9,9,9,9,9,9,
9,2,1,9,8,0,0,0,4,9,
9,0,9,0,0,9,9,9,9,9,
9,0,0,0,1,0,9,0,1,9,
9,0,9,9,7,0,0,0,1,9,
9,0,0,0,0,0,9,9,9,9,
9,0,9,9,0,0,0,0,1,9,
9,1,9,9,9,0,9,9,9,9,
9,1,1,1,9,0,0,0,3,9,
9,9,9,9,9,9,9,9,9,9