12
9,9,9,9,9,9,9,9,9,7,
9,0,0,0,0,0,0,2,0,9,
9,0,0,0,0,0,0,0,2,9,
9,9,0,0,0,0,0,0,0,9,
9,2,0,0,8,0,0,0,0,9,
9,9,0,0,2,0,0,0,0,9,
9,0,0,0,0,0,0,0,0,9,
9,0,0,0,0,0,0,0,9,9,
9,2,0,0,0,0,0,0,2,9,
9,9,9,9,9,9,9,9,9,9,

