15
9,9,9,9,9,7,9,9,9,9
9,9,0,0,0,0,0,3,9,9
9,0,9,0,0,0,0,9,0,9
9,0,0,9,0,0,9,0,0,9
9,0,0,4,9,9,1,0,0,9
9,0,0,0,9,9,0,0,8,9
9,0,0,9,2,0,9,0,0,9
9,0,9,0,0,0,0,9,0,9
9,6,0,0,0,0,0,0,9,9
9,9,9,9,9,9,9,9,9,9
