12
9,9,9,9,9,9,9,9,9,9
9,0,0,0,0,0,0,0,0,9
9,0,9,9,9,9,9,0,0,9
9,0,9,0,0,0,9,0,0,9
9,0,9,0,9,0,9,0,0,9
9,0,9,8,9,0,9,0,0,9
9,0,9,9,9,0,9,0,0,9
9,0,0,0,0,0,9,0,0,9
9,6,0,0,5,0,9,1,7,9
9,9,9,9,9,9,9,9,9,9
