13
9,9,9,9,9,9,9,9,9,9
9,0,6,0,0,9,0,0,0,9
9,0,9,0,0,9,0,9,0,9
9,0,9,0,0,0,8,9,0,9
9,0,9,0,0,9,0,9,5,9
9,0,9,9,9,9,9,9,9,9
9,2,9,0,2,9,5,9,6,9
9,0,9,0,0,0,0,9,6,9
9,0,0,0,0,9,7,9,6,9
9,9,9,9,9,9,9,9,9,9
