12
9,9,9,9,9,9,9,9,9,9
9,6,0,0,9,0,0,6,0,9
9,0,0,9,9,9,0,9,9,9
9,0,9,0,9,0,9,3,9,9
9,9,0,9,0,9,0,0,0,9
9,0,9,9,9,9,9,9,9,9
9,9,0,9,0,0,0,9,8,9
9,0,0,0,0,9,0,9,0,9
9,0,0,9,0,9,0,0,0,9
7,9,9,9,9,9,9,9,9,9
