12
9,9,9,9,9,9,9,9,9,9,
9,2,9,0,6,0,0,0,0,9,
9,0,9,0,0,9,9,9,9,9,
9,1,0,8,9,0,9,0,0,9,
9,0,9,9,9,0,0,4,0,9,
9,0,0,0,0,0,9,9,9,9,
9,1,9,0,0,0,0,0,1,9,
9,1,9,9,9,0,9,9,9,9,
9,1,6,6,9,0,0,0,3,9,
9,9,9,9,9,9,7,9,9,9,
