13
9,9,9,9,9,9,9,9,9,9
9,0,0,0,0,0,0,0,0,9
9,0,9,9,9,9,9,9,0,9
9,0,9,0,2,3,4,9,0,9
9,0,9,9,0,0,5,9,0,9
9,0,0,9,0,6,9,0,0,9
9,0,0,9,0,0,9,0,0,9
9,0,0,9,0,0,9,0,0,9
9,7,0,0,9,9,9,0,8,9
9,9,9,9,9,9,9,9,9,9
