      ██    ██
    ██    ██  
  ██    ██    
██    ██      
  ██    ██    
    ██    ██  
      ██    ██

██          ██      
  ██      ██  
    ██  ██ 
      ██ 