4
9,9,9,7,9,9,9,9,9,9
9,6,9,0,0,0,0,0,0,9
9,9,9,0,0,0,0,0,0,9
9,0,0,8,0,0,0,0,0,9
9,0,0,0,0,0,0,9,0,9
9,0,0,0,0,0,0,9,0,9
9,0,0,0,0,0,0,9,0,9
9,0,0,0,9,9,9,9,1,9
9,0,0,0,0,0,1,1,1,9
9,9,9,9,9,9,9,9,9,9
