13
9,9,9,9,9,9,9,9,9,9
9,6,9,7,9,0,0,0,0,9
9,6,9,0,0,0,0,9,0,9
9,6,9,5,9,2,0,9,2,9
9,9,9,9,9,9,9,9,0,9
9,5,9,0,9,0,0,9,0,9
9,0,9,8,0,0,0,9,0,9
9,0,9,0,9,0,0,9,0,9
9,0,0,0,9,0,0,6,0,9
9,9,9,9,9,9,9,9,9,9
